. . . . . . . . . .
. . . . . . . . . .
. . # . . # . . . .
. . # @ . # . . . .
. . . . . # . . . .
. . . . . # . . . .
. . . . . # . . . .
. . # # # # . . . .
. . . . . . . . . .
. . . . . . . . . .